### Sokolnicheskaya - Red Line
1 6 3226 3210 4339 576 3165 3394 
1 5 3394 3393 674 3120 3106 
1 6 3106 3100 4342 3070 3053 3042 
1 5 3042 3030 2896 2971 2961 
1 7 2961 2949 3082 4299 4535 2904 2889 
1 7 2889 2884 4538 3714 4283 2776 2763 
1 8 2763 2751 4278 3702 3691 3684 2703 2693 
1 7 2693 2682 3681 3680 3996 2547 2513
1 6 2513 2493 3668 3665 2407 2397 
1 13 2397 2378 3988 3980 2180 2159 3642 4551 3603 3594 3584 1922 1915 
1 7 1915 1902 4183 3567 1434 1823 1802 
1 7 1802 1781 4548 4148 3520 1651 1642
1 6 1642 1635 4128 3501 1573 1562 
1 5 1562 1548 4335 3495 3492 
### Sokolnicheskaya - Emerald City
1 3 3481 1381 1369
1 6 1369 1353 3472 4109 1316 1305 
1 6 1305 1292 3468 4105 1257 1244 
### Zamoskvoretskaya
1 6 3276 3267 3756 4060 3243 3240 
1 6 3240 3396 3748 4058 3188 3179 
1 6 3179 3158 3741 4070 3099 3084 
1 5 3084 3066 3737 3036 3027 
1 5 3027 3002 3733 2957 2950 
1 6 2950 2935 3727 4048 2894 2887 
1 7 2887 2877 3682 3713 3706 2714 2706 
1 7 2706 2691 4032 315 447 2591 2582 
1 12 2582 2572 3835 4446 4023 3995 3667 3664 3987 3655 2333 2318
1 13 2318 2291 3623 4072 3941 3605 3925 3586 3569 3903 4621 1701 1693 
1 8 1693 1683 3521 3512 3503 4628 1525 1522 
1 9 1522 1516 3847 3491 3485 3844 3480 1365 1355 
1 11 1355 1342 3475 1322 1312 1294 3465 4102 4068 1211 1207 
1 5 1207 1191 3456 1156 1128 
1 5 1128 1101 3441 1060 1052 
1 5 1052 1045 3434 1015 1007 
1 5 1007 999 3429 970 963 
1 5 963 956 3425 931 914 
1 8 914 906 4462 3420 3421 4463 904 915 
### Arbatsko-Pokrovskaya - Mitino to GWC
1 6 3217 3202 249 4055 3141 3135 
1 6 3135 3126 561 4052 3029 3017 
1 11 3017 2993 253 4047 2868 2855 2835 2813 2570 2753 2744 
1 7 2744 2729 58 4269 317 2619 2612 
1 6 2612 2596 74 4005 2475 2469 
1 6 2469 2457 3326 3983 2283 2263 
1 6 2263 2195 4657 437 2071 2058 
1 9 2058 2039 3597 3923 3585 3915 3574 1871 1856 
1 14 1856 1829 3552 3538 3531 3869 3518 3801 3799 3790 3788 3791 3792 3885 
### Arbatsko-Pokrovskaya - Arbat to Partizanskaya
1 4 3895 3793 1853 1874 
1 10 1874 1881 4425 204 3929 150 3939 211 2170 2197 
1 8 2197 2212 3962 178 3963 4554 2171 2198 
1 8 2198 2179 4557 3629 3630 3631 2173 2200 
1 14 2200 2222 3964 2190 3820 3822 247 3967 216 3968 4606 4609 2231 2202 
1 7 2202 2248 4230 4239 751 2359 2373 
1 6 2373 2394 4251 427 2425 2431 
1 6 2431 2441 4257 744 2487 2508 
1 5 2508 2537 160 2573 2584 
1 3 2584 2594 4265 
### Arbatsko-Pokrovskaya - Pervomayskaya
1 8 782 2637 2646 2658 4 4275 2718 2737 
1 6 2737 2743 456 4286 2803 2826 
### Filovskaya - Polis
1 2 2322 2308 
### Filovskaya - Arbatskaya to Kuntsevskaya
1 2 2321 2330 
1 6 2321 2329 180 167 2328 2320 
1 9 2320 2306 192 3955 173 3945 140 2027 3378 
1 9 3378 2006 3919 1940 1935 3905 3560 1779 1747 
1 7 1747 1778 3559 3899 3571 3398 3400 
1 5 3400 3402 3592 1982 1999 
1 5 1999 2008 187 2034 2056 
1 5 2056 2067 3612 2114 2151 
1 5 2151 2168 3626 2250 2288 
1 5 2288 2302 3648 2354 2374 
1 6 2374 2386 4498 376 2275 2263 
### Filovskaya - Europe 1
1 9 3378 2026 3606 3613 3625 3647 3651 2349 2372 
1 5 2372 2390 3662 2437 2458 
### Filovskaya - Europe 2 to GWC
1 5 2372 2381 3660 2380 2371 
1 12 2371 2347 3644 3954 3611 3818 3817 3602 3587 3842 1939 1924 
1 6 1924 1917 4496 3575 1872 1856 
### Koltsevaya (Hanza)
1 10 1953 1960 4428 4398 4399 4400 4401 4402 2476 2509 
1 8 2509 2539 4403 4404 4405 4406 2806 2828 
1 8 2828 2839 4408 4409 4410 4411 2964 2977 
1 12 2977 2987 3966 2175 3840 3841 3965 2227 3972 2225 2930 2928 
1 8 2928 2922 2189 776 4541 4544 2849 2830 
1 13 2830 2811 3826 2223 4407 3807 1754 1719 3811 3539 3810 2245 2201 
1 9 2201 2163 1741 3549 1727 3809 3570 1839 1826 
1 10 1826 1805 3554 1718 4394 4391 4389 4388 1593 1577 
1 7 1577 1561 4386 4413 4385 1540 1552 
1 8 1552 1534 4654 4414 4383 1528 1556 1566 
1 12 1566 1551 1538 4384 4387 4412 4390 4392 4393 4395 1687 1696 
1 7 1696 1706 4396 4397 4421 1926 1953 
### Kaluzhsko-Rizhskaya
1 6 3344 3337 4332 3771 3320 3314 
1 5 3314 3306 3766 3300 3294 
1 5 3294 3287 3759 3273 3265 
1 6 3265 3258 3753 4192 3232 3219 
1 6 3219 3204 4310 3746 3176 3164 
1 6 3164 3146 4110 3740 3093 3081 
1 6 3081 3063 4331 3736 2990 2976 
1 6 2976 2963 4640 3722 2863 2853 
1 8 2853 2824 3712 4041 3705 4589 2628 2623 
1 10 2623 2605 3836 3831 3829 3827 3638 4592 2127 2111 
1 8 2111 2088 3604 3590 3580 3566 1817 1801 
1 11 1801 1771 4624 3882 3534 3527 3804 3522 3517 1631 1621 
1 7 1621 1615 4644 3493 3489 1441 1428 
1 5 1428 1407 3482 1383 1370 
1 5 1370 1349 3474 1331 1320 
1 5 1320 1299 3470 1278 1272 
1 5 1272 1266 3466 1239 1229 
1 5 1229 1216 3462 1193 1185 
1 5 1185 1173 3454 1162 1134 
1 5 1134 1105 3446 1084 1081 
1 5 1081 1066 3436 1034 1027 
1 5 1027 1010 3430 991 983 
1 5 983 969 3427 946 941 
1 6 941 918 3418 4457 888 884 
1 6 884 881 3416 3414 847 844 
1 8 844 840 4449 3412 4450 3413 850 845 
### Tagansko-Krasnopresnenskaya
1 5 3178 3156 513 3104 3097 
1 5 3097 3075 3245 3012 3000 
1 5 3000 2974 550 2926 2918 
1 5 2918 2900 1791 2844 2827 
1 5 2827 2805 3715 2781 2766 
1 5 2766 2750 3708 2719 2708 
1 5 2708 2695 3694 2663 3390 
1 5 3390 2639 3683 2606 3389 
1 7 3389 2581 3679 4018 4632 3388 2510 
1 10 2510 2524 4007 3675 3676 3677 3678 4008 2490 2511 
1 12 2511 2497 4579 3526 4009 3519 4010 3507 4011 4584 2451 2443 
1 8 2443 2433 3661 3654 3639 2226 2129 2112 
1 8 2112 2095 3608 3595 3578 3911 1895 1876 
1 6 1876 1863 3558 3524 3367 3364
1 7 3364 3363 3873 3864 1513 1582 1568 
1 6 1568 1547 4416 4415 1509 1504 
1 5 1504 1491 3490 1459 1442 
1 5 1442 1429 3487 1453 1443 
1 9 1443 1430 3486 1426 1444 1431 3488 1457 1445 
1 5 1445 1422 3484 1401 1392
### Kalininskaya
1 12 3373 3372 3889 3542 3543 3890 3544 3545 3891 3547 1722 1744 
1 7 1744 1726 3548 4160 4161 1723 1745 
1 8 1745 1766 3550 3808 3551 4173 1852 1870 
1 5 1870 1884 3577 1931 1954 
1 5 1954 1963 3593 2017 2030 
1 5 2030 2044 3609 3379 3383 
1 5 3383 3385 3617 2100 2124 
### Serpukhovsko-Timiryazevskaya
1 5 916 3352 3773 3338 3333 
1 5 3333 3329 3770 3315 3311 
1 5 3311 3304 3760 1664 3286 
1 5 3286 3284 3758 3260 3256 
1 5 3256 3252 3754 3235 3220 
1 5 3220 3206 3750 3195 3189 
1 5 3189 3170 3745 3134 3127 
1 5 3127 3107 3738 3059 3051 
1 10 3051 3041 4636 3729 3726 3721 3718 3716 2794 2784 
1 10 2784 2768 4037 3700 3697 4029 3687 4026 2545 2512 
1 11 2512 2483 4573 4576 3666 3663 3657 2340 2322 2105 2087 
1 14 2087 2062 4244 3657 4560 4563 3933 3596 3572 3909 4566 3564 1803 1785 
1 11 1785 1735 3879 3533 3514 3499 3858 4648 4651 1495 1489 
1 5 1489 1472 3473 1395 1384 
1 5 1384 1359 3797 1306 1296 
1 5 1296 1279 3467 1252 1241 
1 5 1241 1223 3464 1201 1189 
1 5 1189 1178 3455 1148 1124 
1 5 1124 1092 3442 1074 1067 
1 5 1067 1054 3435 1036 1028 
1 5 1028 1011 3432 996 986 
1 5 986 973 3428 952 942 
1 5 942 921 3419 892 885 
1 5 885 878 3417 872 867 
1 6 867 863 3415 4454 855 845 
### Lyublinsko-Dmitrovskaya Line Maryina Roscha and Dostoevskaya
1 5 3152 3137 3739 3091 3080 
1 2 3080 3061 
### Lyublinsko-Dmitrovskaya Line - Trubnaya to the end
1 7 3735 3730 3724 3717 4290 2797 2785 
1 6 2785 2774 3707 3698 2679 2666 
1 14 2666 2662 4519 3685 4595 3837 3834 3832 3830 3828 3825 4603 2098 2090 
1 9 2090 2065 4218 3601 3815 4200 3582 1911 1899 
1 7 1899 1868 4614 3530 4617 1613 1607 
1 6 1607 1590 3850 3494 1498 1488 
1 5 1488 1468 3483 1389 1372 
1 5 1372 1352 3476 1336 1332 
1 5 1332 1314 3471 1289 1281 
1 5 1281 1271 3469 1248 1240 
1 5 1240 1221 3463 1199 1186 
1 5 1186 1176 3457 1157 1129 
1 5 1129 1103 3443 1079 1069 
1 5 1069 1058 3437 1041 3358 
1 5 3358 1020 3431 987 981 
1 6 981 965 4468 3426 933 915 
1 4 4464 3422 905 3357 
### Kakhovskaya
1 6 1124 1136 4473 3448 1107 1125 
1 6 1125 1138 4065 3449 1139 1126 
1 5 1126 1140 3450 1109 1127 
1 5 1127 1142 3451 1110 1128 
### Redline triple passage
1 5 2397 2383 4501 2334 2318 
1 5 2318 2309 3643 2243 2200 
### Redline-Kuznetsky Most passage
1 6 2513 2500 4504 3669 2430 2443 
### Reich intersections
1 6 2582 2571 4445 4512 2542 2511 
1 5 2582 2588 4513 2529 2512 
1 6 2511 2543 856 859 2492 2512 
### Venice intersections
1 5 1693 1702 3805 1749 1801 
1 5 1693 1698 3536 3371 3373 
1 5 1801 1750 3541 3376 3373 
### Arbat intersection
1 6 1874 1887 202 137 2001 3378 
### Polis intersections
1 6 2198 2214 3616 4433 2172 2199 
1 6 2198 2239 3615 4432 2301 2322 
1 7 2198 2240 2215 3821 2206 2063 2087 
1 6 2322 2340 3640 4441 2072 2087 
1 7 2322 2332 2145 3821 2146 2216 2199 
1 6 2087 2076 4442 3641 2241 2199 
### Kitay-Gorod intersection
1 6 2111 2121 3948 3614 2089 2112 
### Hanza - Dobryninskaya-Serpukhovskaya
1 6 1552 1531 4533 3019 1501 1489 
### Hanza - Taganskaya intersections
1 5 1826 1834 3565 1860 1876 
1 5 1876 1851 3562 1774 1744 
1 5 3565 1825 1806 1773 1744 
1 4 1876 1895 3911 3578 
### Hanza - Kurskaya intersections
1 6 2201 2230 4437 270 2247 2202 
1 5 2202 2177 3620 2108 2090 
1 6 2090 2107 3619 4600 2164 2201 
### Hanza - Great service tunnel
1 6 4413 3855 3498 3509 1627 3512 
1 6 3509 3505 3504 3506 1638 3517 
1 4 3506 3513 1632 3514 
### Hanza - Taganskaya service tunnels
1 7 1727 1923 3583 3573 3896 1753 3548 
1 4 3583 3579 3912 3911 
### Hanza - Kurskaya service tunnel
1 6 3539 2289 3658 3653 2280 3825 
### Zamoskvoretskaya-Arbatsko-Pokrovskaya service tunnel
1 5 2309 3650 3637 2224 2190 
### Zamoskvoretskaya-Lyublinsko-Dmitrovskaya service tunnel
1 6 4464 4467 3424 3433 1002 3431 
### Polis service tunnels
1 12 2322 2339 4245 3652 3621 2278 3635 3839 3819 1786 2218 3630 
1 6 2278 3649 2268 3632 3981 3980 
### Kashirskaya bypass service tunnel
1 8 4088 4090 3452 4094 3458 4095 1169 3456 
### D6 Command Center
1 4 1956 4357 1997 3813 
1 4 1956 4357 1996 1952 
1 4 1956 4357 1967 3950 
1 4 1956 4357 1968 3588 
