1 147 3344 3337 4332 3771 3319 3314 3309 4857 3766 3300 3294 3292 4851 3759 3273 3265 3257 3753 4192 3233 3219 3204 4310 3746 3176 3164 3147 4110 3740 3093 3081 3063 4331 3736 2990 2976 2963 4827 4640 3722 4821 2863 2853 2823 3712 4041 3705 4589 2628 2623 2605 3836 4793 3831 3829 3827 3638 4592 2128 2111 2088 3604 4746 3590 4735 3580 3566 1817 1801 1771 4624 3882 3534 3527 3804 3522 3517 1631 1621 1615 4644 3493 4921 3489 1441 1428 1412 4902 3482 1383 1370 1354 4896 3474 1331 1320 1308 4890 3470 1278 1272 1268 4887 3466 1239 1229 1218 4884 3462 1193 1185 1177 4881 3454 1162 1134 1105 4877 3446 1084 1081 1066 4874 3436 1035 1027 1010 4872 3430 991 983 977 4869 3427 946 941 918 3418 4457 888 884 877 3416 4866 3414 852 844 
1 60 844 848 4449 3412 4450 3413 850 845 855 4454 3415 863 867 872 3417 879 885 892 3419 922 942 952 3428 974 986 995 3432 1012 1028 1036 3435 1054 1067 1073 3442 1093 1124 1148 3455 1179 1189 1202 3464 1223 1241 1252 4668 3467 1283 1296 1307 4671 3797 1359 1384 1396 3473 4673 1472 1489 
1 22 1124 1136 4473 3448 1137 1125 1138 4065 3449 1108 1126 1140 4087 3450 4088 1141 1127 1142 3451 4474 1143 1128 
1 6 1489 1501 3019 4533 1531 1552 
1 77 2397 2383 4707 4501 2333 2318 2292 3623 4072 3941 3605 3925 3586 3569 3903 4621 1702 1693 1683 3521 3512 3503 4628 1525 1522 1516 3847 3491 3485 3844 3480 1365 1355 1343 3475 1321 1312 1294 3465 4102 4068 1211 1207 1191 3456 4665 1156 1128 1100 4661 3441 1060 1052 1045 3434 1015 1007 999 3429 970 963 956 3425 931 914 906 4462 3420 3421 4463 926 915 927 4464 3422 905 3357 
1 66 915 934 3426 4468 965 981 987 3431 1019 3358 1042 3437 1058 1069 1079 3443 1103 1129 1157 3457 1176 1186 1199 3463 1221 1240 1248 3469 1271 1281 1289 3471 4893 1314 1332 1336 3476 4899 1352 1372 1388 3483 4904 1469 1488 1497 3494 4924 3850 1590 1607 1612 4617 4930 3530 4614 1869 1899 1911 3582 4200 3815 3601 4218 2065 2090 
1 108 3276 3266 3756 4060 3243 3240 3218 3748 4058 3187 3179 3158 3741 4070 3098 3084 3066 4701 3737 3036 3027 3002 4698 3733 2957 2950 2935 3727 4048 2894 2887 2877 3682 3713 3706 2714 2706 2710 4032 315 447 3835 4446 2592 2582 2572 3667 3664 3987 3655 4775 2333 2318 2292 3643 4947 2243 2200 2181 3964 2190 3820 3822 247 3967 216 3968 4606 4609 2231 2202 2248 4230 4239 751 2359 2373 2394 4251 427 2425 2431 2441 4257 744 2487 2508 2537 160 4953 2576 2584 2594 4265 4418 782 2629 2646 2658 4 4275 2718 2737 2742 456 4286 2803 2826 
1 94 2200 2221 3631 3630 4758 4757 4554 3629 4557 2214 2198 2213 3963 178 3962 2212 2197 2170 211 3939 150 3929 204 4425 1888 1874 1880 3793 3895 4422 3885 3792 3791 3788 3790 1865 1856 1864 3574 3915 2051 2058 2059 437 4657 2233 2263 2274 3983 3326 3571 2456 2469 2475 4005 74 2596 2612 2619 3799 3801 3518 3869 3531 3538 3552 3585 3923 3597 317 4269 58 2729 2744 2752 253 2570 2814 2835 2854 2868 4047 2992 3017 3028 4052 561 3126 3135 3140 4055 249 3202 3217 
1 60 2263 2283 376 4498 2354 2374 2396 3648 2264 2288 2294 3626 2166 2151 2167 3612 2060 2056 2061 187 2004 1999 2005 3592 1661 3400 3398 3899 3559 1768 1747 1769 3560 3919 2023 3378 2024 140 3945 173 3955 192 2306 2320 2328 167 180 2329 2321 2330 154 4245 4772 2331 2322 2301 2145 3821 2242 2199 
1 15 1856 1872 3575 4496 1913 1924 1939 4689 3842 3587 3611 3954 3644 2346 2371 
1 6 2371 2380 3660 4950 2381 2372 
1 19 2458 2446 4695 3662 2390 2372 2349 3651 3625 4753 3613 3606 2026 3378 2001 137 202 1887 1874 
1 109 3226 3210 4339 576 3165 3394 3393 4713 674 3120 3106 3100 4342 3070 3053 3042 3030 4710 2896 2971 2961 2949 3082 4299 4535 2904 2889 2884 4538 3714 4283 2776 2763 2751 4278 3702 3691 3684 2703 2693 2682 3681 4797 3680 3996 2547 2513 2493 3668 3665 2407 2397 2378 3988 3980 4768 4763 3642 2242 2199 2172 4551 3603 4745 3594 4738 3584 1922 1915 1902 4183 3567 1434 1823 1802 1781 4548 4148 3520 1651 1642 1635 4128 3501 1573 1562 1548 4335 3495 3492 4126 1475 1467 1446 4120 4719 3481 1381 1369 1353 3472 4109 1316 1305 1292 3468 4105 1257 1244 
1 11 1801 1749 3805 4683 1702 1693 1698 4680 3536 3371 3373 
1 50 1801 1782 4932 3541 3376 3373 3372 3889 3542 3543 3890 3544 3545 3891 3547 1763 1744 1726 3548 4160 4161 1765 1745 1766 3550 3808 3551 4173 1852 1870 1884 3577 4935 1945 1954 1966 4938 3593 2017 2030 2044 4941 3609 3381 3383 3385 3617 4944 2136 2124 
1 128 1392 1401 3484 1432 1445 1457 4912 3488 1456 1444 1455 4910 3486 1454 1443 1453 4911 3487 1452 1442 1459 3490 4917 1491 1504 1509 4415 4416 1547 1568 1582 1513 4926 3864 3873 3361 3364 3367 4677 3524 3558 4730 1851 1876 1895 3911 3578 3595 3608 2084 2112 2129 2226 3639 3654 4781 3661 4584 4011 2428 2443 2448 3507 4010 3519 4009 3526 4579 2528 2511 2527 4788 4008 3678 3677 3676 3675 4007 2524 2510 3388 4632 4018 3679 2581 3389 2606 4800 3683 2639 3390 2663 4803 3694 2695 2708 2719 4809 3708 2750 2766 2781 4815 3715 2805 2827 2844 4818 1791 2899 2918 2927 4825 550 2974 3000 3013 4830 3245 3602 4835 3075 3097 3104 513 4703 3156 3178 
1 89 1489 1495 4651 4648 3858 3499 3514 4727 3533 3879 1757 1785 1803 3564 4566 3909 3572 3596 3933 4563 2063 2087 2104 4560 3663 3621 3652 3666 2483 2512 2544 4037 4573 4026 3687 4029 3697 3700 2768 2784 2794 3716 3718 3721 3726 3729 4636 3034 3051 3058 3738 4832 3108 3127 3133 3745 4838 3171 3189 3195 4842 3750 3205 3220 3235 4845 3754 3253 3256 3263 4848 3758 3284 3286 3291 3760 4853 3304 3311 3316 3770 4859 3329 3333 3338 3773 4863 3350 916 
1 35 2090 2107 4603 3825 3828 4785 3830 3832 3834 4791 3837 4595 3685 4519 2652 2666 2679 4806 3698 3707 4812 2762 2785 2796 4290 3717 3724 3730 3735 3060 3080 3092 3739 3137 3152 
1 5 2784 2790 2921 2791 2785 
1 6 2976 2956 4528 3731 2933 2928 
1 5 1826 1834 3565 1860 1876 
1 5 1744 1774 3562 1851 1876 
1 6 1826 1812 1825 1806 1773 1744 
1 6 2090 2108 3619 4600 2163 2201 
1 6 2201 2230 4437 270 2247 2202 
1 5 2108 3620 4692 2177 2202 
1 6 2111 2121 3948 3614 2122 2112 
1 6 2087 2105 3640 4441 2171 2198 
1 6 2198 2157 4433 3616 2241 2199 
1 6 2198 2214 3615 4432 2308 2322 
1 5 2623 2627 3817 2672 2666 
1 15 3517 1638 4725 3506 3504 4722 4723 3505 4721 3498 3855 4413 4386 1586 1577 
1 6 1566 1581 4484 1598 1611 1621 
1 6 1696 1704 3540 4490 1814 1802 
1 6 3378 2011 209 4741 1957 1953 
1 6 1874 1888 215 4685 1925 1953 
1 6 2830 2850 2705 4524 1174 2889 
1 100 1953 1957 4428 4398 4399 4400 4401 4402 2476 2509 2539 4403 4404 4405 4406 2816 2828 2847 4408 4409 4410 4411 2964 2977 2987 3966 2175 3840 3841 3965 2227 3972 2225 2930 2928 2922 2189 776 4541 4544 2849 2830 2821 3826 2223 4407 3807 1754 1719 3811 3539 3810 2246 2201 2163 1741 3549 1727 3809 3570 1839 1826 1792 3554 1718 4394 4391 4389 4388 1593 1577 1586 4386 4413 4385 1540 1552 1534 4654 4414 4383 1528 1556 1566 1574 1538 4384 4387 4412 4390 4392 4393 4395 1687 1696 1706 4396 4397 4421 1925 
1 6 2828 2847 3719 4523 2877 2887 
1 6 2977 2995 3734 4531 3033 3051 
1 6 1522 1525 3496 4481 1554 1577 
1 7 3683 2621 3699 3695 3686 2567 4404 
1 7 3686 4376 4380 4381 4382 2689 4406 
1 10 4827 4828 3555 4114 4184 3537 3732 4188 2962 2227 
1 7 2322 2332 2278 4777 3839 3981 3980 
1 4 4777 2268 3632 3981 
1 7 3630 2218 4762 1786 4767 3819 3839 
1 5 3506 4724 3513 4726 4727 
1 4 3505 3509 1627 3512 
1 7 3520 1659 3525 4151 3535 1783 4396 
1 9 4464 4467 4715 4716 3424 3433 4717 1002 3431 
