1 6 3226 3210 4339 576 3165 3394 
1 6 3106 3100 4342 3070 3053 3042 
1 7 2961 2949 3082 4299 4535 2904 2889 
1 7 2889 2884 4538 3714 4283 2776 2763 
1 8 2763 2751 4278 3702 3691 3684 2703 2693 
1 7 2693 2682 3681 3680 3996 2547 2513 
1 6 2513 2493 3668 3665 2407 2397 
1 7 1915 1902 4183 3567 1434 1823 1802 
1 7 1802 1781 4548 4148 3520 1651 1642 
1 6 1642 1635 4128 3501 1573 1562 
1 6 1369 1353 3472 4109 1316 1305 
1 6 1305 1292 3468 4105 1257 1244 
1 6 3276 3267 3756 4060 3243 3240 
1 6 3240 3396 3748 4058 3188 3179 
1 6 3179 3158 3741 4070 3099 3084 
1 6 2950 2935 3727 4048 2894 2887 
1 7 2706 2691 4032 315 447 2591 2582 
1 12 2582 2572 3835 4446 4023 3995 3667 3664 3987 3655 2333 2318 
1 17 2318 2291 3623 4072 3941 3605 3925 3586 3569 3903 4621 1701 1693 1702 4683 3805 1750 
1 9 1522 1516 3847 3491 3485 3844 3480 1365 1355 
1 11 1355 1342 3475 1322 1312 1294 3465 4102 4068 1211 1207 
1 5 1207 1191 3456 1156 1128 
1 5 1128 1101 3441 1060 1052 
1 5 1052 1045 3434 1015 1007 
1 5 1007 999 3429 970 963 
1 5 963 956 3425 931 914 
1 8 914 906 4462 3420 3421 4463 904 915 
1 6 3217 3202 249 4055 3140 3135 
1 6 3135 3126 561 4052 3028 3017 
1 11 3017 2993 4047 2868 2855 2835 2814 2570 253 2753 2744 
1 17 2744 2729 58 4269 317 3597 3923 3585 3552 3538 3531 3869 3518 3801 3799 2619 2612 
1 6 2612 2596 74 4005 2475 2469 
1 12 2469 2457 3571 3326 3983 2274 2263 2233 4657 437 2046 2058 
1 6 2058 2051 3915 3574 1836 1856 
1 7 1856 1843 3790 3788 3791 3792 3885 
1 4 3895 3793 1853 1874 
1 10 1874 1881 4425 204 3929 150 3939 211 2170 2197 
1 8 2197 2212 3962 178 3963 4554 2171 2198 
1 7 2202 2248 4230 4239 751 2359 2373 
1 6 2373 2394 4251 427 2425 2431 
1 6 2431 2441 4257 744 2487 2508 
1 5 2508 2537 160 2573 2584 
1 3 2584 2594 4265 
1 8 782 2637 2646 2658 4 4275 2718 2737 
1 6 2737 2743 456 4286 2803 2826 
1 6 2321 2329 180 167 2328 2320 
1 14 2320 2306 192 3955 173 3945 140 2027 3378 2011 209 4741 1957 1953 
1 14 2372 2381 3660 2380 2371 2346 3644 3954 3611 3587 3842 4689 1939 1924 
1 6 1924 1912 4496 3575 1872 1856 
1 15 2509 2476 4402 4401 4400 4399 4398 4428 1960 1953 1936 4685 215 1888 1874 
1 8 2509 2539 4403 4404 4405 4406 2806 2828 
1 8 2828 2839 4408 4409 4410 4411 2964 2977 
1 12 2977 2987 3966 2175 3840 3841 3965 2227 3972 2225 2930 2928 
1 8 2928 2922 2189 776 4541 4544 2849 2830 
1 13 2830 2811 3826 2223 4407 3807 1754 1719 3811 3539 3810 2245 2201 
1 9 2201 2163 1741 3549 1727 3809 3570 1839 1826 
1 15 1826 1805 3554 1718 4394 4391 4389 4388 1593 1577 1554 4481 3496 1526 1522 
1 7 1577 1561 4386 4413 4385 1540 1552 
1 8 1552 1534 4654 4414 4383 1528 1556 1566 
1 17 1566 1551 1538 4384 4387 4412 4390 4392 4393 4395 1687 1696 1704 3540 4490 1814 1802 
1 7 1696 1706 4396 4397 4421 1926 1953 
1 6 3219 3204 4310 3746 3176 3164 
1 6 3164 3146 4110 3740 3093 3081 
1 6 3081 3063 4331 3736 2990 2976 
1 8 2853 2824 3712 4041 3705 4589 2628 2623 
1 7 1621 1615 4644 3493 3489 1441 1428 
1 5 1428 1407 3482 1383 1370 
1 5 1370 1349 3474 1331 1320 
1 5 1320 1299 3470 1278 1272 
1 5 1272 1266 3466 1239 1229 
1 5 1229 1216 3462 1193 1185 
1 5 1185 1173 3454 1162 1134 
1 5 1134 1105 3446 1084 1081 
1 5 1081 1066 3436 1034 1027 
1 5 1027 1010 3430 991 983 
1 5 983 969 3427 946 941 
1 6 941 918 3418 4457 888 884 
1 6 884 881 3416 3414 847 844 
1 8 844 840 4449 3412 4450 3413 850 845 
1 12 3389 2581 3679 4018 4632 3388 2510 2478 3674 4507 2523 2509 
1 10 2510 2524 4007 3675 3676 3677 3678 4008 2490 2511 
1 8 2443 2433 3661 3654 3639 2226 2129 2112 
1 8 2112 2095 3608 3595 3578 3911 1895 1876 
1 12 1568 1582 1513 3864 3873 3363 3364 3360 4486 3510 1612 1607 
1 6 1568 1547 4416 4415 1509 1504 
1 5 1504 1491 3490 1459 1442 
1 5 1442 1429 3487 1453 1443 
1 9 1443 1430 3486 1426 1444 1431 3488 1457 1445 
1 5 1445 1422 3484 1401 1392 
1 17 1744 1722 3547 3891 3545 3544 3890 3543 3542 3889 3372 3373 3371 3536 4680 1698 1693 
1 8 1745 1766 3550 3808 3551 4173 1852 1870 
1 5 1870 1884 3577 1931 1954 
1 5 1954 1963 3593 2017 2030 
1 5 2030 2044 3609 3379 3383 
1 5 3383 3385 3617 2100 2124 
1 19 2785 2791 2921 2790 2784 2794 3716 3718 3721 3726 3729 4636 3041 3051 3033 4531 3734 2995 2977 
1 10 2784 2768 4037 3700 3697 4029 3687 4026 2545 2512 
1 14 2087 2062 4244 3657 4560 4563 3933 3596 3572 3909 4566 3564 1803 1785 
1 5 1296 1279 3467 1252 1241 
1 5 1241 1223 3464 1201 1189 
1 5 1189 1178 3455 1148 1124 
1 5 1124 1092 3442 1074 1067 
1 5 1067 1054 3435 1036 1028 
1 5 1028 1011 3432 996 986 
1 5 986 973 3428 952 942 
1 5 942 921 3419 892 885 
1 5 885 878 3417 872 867 
1 6 867 863 3415 4454 855 845 
1 5 3152 3137 3739 3091 3080 
1 2 3080 3061 
1 9 2090 2065 4218 3601 3815 4200 3582 1911 1899 
1 7 1899 1868 4614 3530 4617 1613 1607 
1 6 1607 1590 3850 3494 1498 1488 
1 5 1488 1468 3483 1389 1372 
1 5 1372 1352 3476 1336 1332 
1 5 1332 1314 3471 1289 1281 
1 5 1281 1271 3469 1248 1240 
1 5 1240 1221 3463 1199 1186 
1 5 1186 1176 3457 1157 1129 
1 5 1129 1103 3443 1079 1069 
1 5 1069 1058 3437 1041 3358 
1 5 3358 1020 3431 987 981 
1 6 981 965 4468 3426 933 915 
1 4 4464 3422 905 3357 
1 6 1124 1136 4473 3448 1107 1125 
1 6 1125 1138 4065 3449 1139 1126 
1 5 1126 1140 3450 1109 1127 
1 5 1127 1142 3451 1110 1128 
1 5 2318 2309 3643 2243 2200 
1 6 2513 2500 4504 3669 2430 2443 
1 6 2582 2571 4445 4512 2542 2511 
1 5 2582 2588 4513 2529 2512 
1 6 2511 2543 856 859 2492 2512 
1 5 1801 1750 3541 3376 3373 
1 6 1874 1887 202 137 2001 3378 
1 6 2198 2214 3616 4433 2172 2199 
1 6 2198 2239 3615 4432 2301 2322 
1 7 2198 2240 2215 3821 2206 2063 2087 
1 6 2322 2340 3640 4441 2072 2087 
1 7 2322 2332 2145 3821 2146 2216 2199 
1 6 2087 2076 4442 3641 2241 2199 
1 6 2111 2121 3948 3614 2089 2112 
1 6 1552 1531 4533 3019 1501 1489 
1 5 1826 1834 3565 1860 1876 
1 5 1876 1851 3562 1774 1744 
1 5 3565 1825 1806 1773 1744 
1 4 1876 1895 3911 3578 
1 6 2201 2230 4437 270 2247 2202 
1 6 2090 2107 3619 4600 2164 2201 
1 6 3539 2289 3658 3653 2280 3825 
1 8 4088 4090 3452 4094 3458 4095 1169 3456 
1 4 1956 4357 1997 3813 
1 4 1956 4357 1996 1952 
1 4 1956 4357 1967 3950 
1 4 1956 4357 1968 3588 
1 6 2458 2446 4695 3662 2390 2372 
1 6 3027 3014 4698 3733 2957 2950 
1 6 3084 3066 4701 3737 3036 3027 
1 6 1384 1396 3473 4673 1472 1489 
1 7 1876 1863 3558 3524 4677 3367 3364 
1 6 1899 1882 4492 3563 1775 1745 
1 6 2961 2971 2896 4710 3030 3042 
1 6 3106 3120 674 4713 3393 3394 
1 6 3314 3320 3771 4332 3337 3344 
1 6 3294 3300 3766 4857 3309 3314 
1 6 3265 3273 3759 4851 3292 3294 
1 6 3219 3233 4192 3753 3258 3265 
1 8 2853 2863 4821 3722 4640 4827 2963 2976 
1 9 2372 2349 3651 3625 4753 3613 3606 2026 3378 
1 6 2321 2330 154 4772 2331 2322 
1 18 2397 2378 3988 3980 4768 2180 2159 4763 3642 4750 4551 3603 4745 3594 4738 3584 1922 1915 
1 6 1562 1548 4335 3495 3492 4126 
1 5 1369 1381 3481 4719 4120 
1 6 1621 1611 1598 4484 1581 1566 
1 12 1785 1757 3879 3533 4727 3514 3499 3858 4648 4651 1500 1489 
1 8 1693 1683 3521 3512 3503 4628 1525 1522 
1 6 2397 2383 4707 4501 2334 2318 
1 13 2511 2497 4788 4579 3526 4009 3519 4010 3507 4011 4584 2451 2443 
1 11 2111 2128 4592 3638 3827 3829 3831 4793 3836 2605 2623 
1 16 2666 2662 4519 3685 4595 3837 4791 3834 3832 3830 4785 3828 3825 4603 2107 2090 
1 6 2090 2108 3620 4692 2177 2202 
1 6 3051 3059 3738 4832 3108 3127 
1 6 3127 3134 3745 4838 3171 3189 
1 6 3189 3195 4842 3750 3206 3220 
1 6 3220 3235 4845 3754 3253 3256 
1 6 3256 3263 4848 3758 3284 3286 
1 6 3286 3291 3760 4853 3304 3311 
1 6 3311 3315 3770 4859 3329 3333 
1 6 916 3352 4863 3773 3338 3333 
1 13 3178 3156 4703 513 3105 3097 3075 4835 3602 3245 4830 3013 3000 
1 6 3000 2974 550 4825 2927 2918 
1 6 2918 2900 1791 4818 2845 2827 
1 6 2766 2781 4815 3715 2819 2827 
1 6 2766 2750 3708 4809 2719 2708 
1 6 2708 2695 3694 4803 2663 3390 
1 6 3389 2606 4800 3683 2645 3390 
1 7 1744 1726 3548 4160 4161 1723 1745 
1 6 1296 1306 4671 3797 1359 1384 
1 10 2198 2214 4557 3629 4757 4758 3630 3631 2221 2200 
1 14 2200 2222 3964 2190 3820 3822 247 3967 216 3968 4606 4609 2231 2202 
1 10 1801 1817 3566 3580 4735 3590 4746 3604 2088 2111 
1 11 1621 1631 3517 3522 3804 3527 3534 3882 4624 1771 1801 
1 12 2785 2774 4812 3707 3698 4806 2679 2666 2651 3696 2702 2693 
1 6 2693 2699 4517 3692 2611 2623 
1 7 2887 2883 3682 3713 3706 2714 2706 
1 6 2828 2847 3719 4523 2877 2887 
1 3 4464 907 915 
1 5 2666 2672 3817 2627 2623 
1 6 2976 2956 4528 3731 2933 2928 
1 8 3061 3735 3730 3724 3717 4290 2797 2785 
